Tm,FULL_TEAM_NAME,Week,Opp,TM_Score,Opp_Score,O_1stD,O_Tot_Yd,O_P_Yd,O_R_Yd,O_TO,D_1stD,D_Tot_Yd,D_P_Yd,D_R_Yd,D_TO,Result,Home,ADA_Pred_Mean,LOG_Prediction
nyj,New York Jets,1,Buffalo Bills,17,27,15,254,202,52,2,31,404,306,98,2,0,0,0.138388347,0.19404798333277767
nyj,New York Jets,2,San Francisco 49ers,13,31,17,277,173,104,0,17,359,177,182,1,0,1,0.138388347,0.19404798333277767
nyj,New York Jets,3,Indianapolis Colts,7,36,15,260,151,109,3,21,353,234,119,0,0,0,0.138388347,0.19404798333277767
nyj,New York Jets,4,Denver Broncos,28,37,18,321,192,129,0,21,359,242,117,3,0,1,0.138388347,0.19404798333277767
nyj,New York Jets,5,Arizona Cardinals,10,30,21,285,162,123,0,28,496,369,127,1,0,1,0.138388347,0.19404798333277767
nyj,New York Jets,6,Miami Dolphins,0,24,13,263,148,115,1,18,302,192,110,2,0,0,0.138388347,0.19404798333277767
nyj,New York Jets,7,Buffalo Bills,10,18,17,191,91,100,2,26,422,296,126,1,0,1,0.138388347,0.19404798333277767
nyj,New York Jets,8,Kansas City Chiefs,9,35,13,221,128,93,1,25,496,446,50,0,0,0,0.138388347,0.19404798333277767
nyj,New York Jets,9,New England Patriots,27,30,18,322,257,65,1,30,433,274,159,0,0,1,0.138388347,0.19404798333277767
nyj,New York Jets,11,Los Angeles Chargers,28,34,20,292,196,96,1,28,376,347,29,1,0,0,0.138388347,0.19404798333277767
nyj,New York Jets,12,Miami Dolphins,3,20,10,260,173,87,2,22,345,241,104,2,0,1,0.138388347,0.19404798333277767
nyj,New York Jets,13,Las Vegas Raiders,28,31,24,376,170,206,3,24,440,368,72,2,0,1,0.138388347,0.19404798333277767
nyj,New York Jets,14,Seattle Seahawks,3,40,12,185,116,69,1,28,410,236,174,1,0,0,0.138388347,0.19404798333277767
nyj,New York Jets,15,Los Angeles Rams,23,20,17,289,196,93,0,16,303,189,114,1,1,0,0.138388347,0.19404798333277767
nyj,New York Jets,16,Cleveland Browns,23,16,18,333,202,131,0,23,299,254,45,2,1,1,0.138388347,0.19404798333277767
nyj,New York Jets,17,New England Patriots,14,28,21,350,239,111,2,23,404,238,166,0,0,0,0.138388347,0.19404798333277767
pit,Pittsburgh Steelers,1,New York Giants,26,16,19,349,208,141,1,20,291,262,29,2,1,0,0.140616785,0.2837414459947797
pit,Pittsburgh Steelers,2,Denver Broncos,26,21,19,410,301,109,2,23,319,215,104,2,1,1,0.140616785,0.2837414459947797
pit,Pittsburgh Steelers,3,Houston Texans,28,21,25,387,218,169,0,13,260,231,29,1,1,1,0.140616785,0.2837414459947797
pit,Pittsburgh Steelers,5,Philadelphia Eagles,38,29,25,367,231,136,1,20,336,242,94,2,1,1,0.140616785,0.2837414459947797
pit,Pittsburgh Steelers,6,Cleveland Browns,38,7,18,277,148,129,0,12,220,145,75,2,1,1,0.140616785,0.2837414459947797
pit,Pittsburgh Steelers,7,Tennessee Titans,27,24,23,362,268,94,3,15,292,210,82,0,1,0,0.140616785,0.2837414459947797
pit,Pittsburgh Steelers,8,Baltimore Ravens,28,24,19,221,173,48,1,25,457,192,265,4,1,0,0.140616785,0.2837414459947797
pit,Pittsburgh Steelers,9,Dallas Cowboys,24,19,20,355,309,46,0,19,364,220,144,2,1,0,0.140616785,0.2837414459947797
pit,Pittsburgh Steelers,10,Cincinnati Bengals,36,10,22,377,333,44,0,16,324,185,139,2,1,1,0.140616785,0.2837414459947797
pit,Pittsburgh Steelers,11,Jacksonville Jaguars,27,3,23,373,267,106,1,14,206,133,73,4,1,0,0.140616785,0.2837414459947797
pit,Pittsburgh Steelers,12,Baltimore Ravens,19,14,22,334,266,68,2,10,219,90,129,2,1,1,0.140616785,0.2837414459947797
pit,Pittsburgh Steelers,13,Washington Football Team,17,23,17,326,305,21,1,18,318,273,45,0,0,1,0.140616785,0.2837414459947797
pit,Pittsburgh Steelers,14,Buffalo Bills,15,26,14,224,177,47,2,21,334,230,104,2,0,0,0.140616785,0.2837414459947797
pit,Pittsburgh Steelers,15,Cincinnati Bengals,17,27,12,244,158,86,3,13,230,78,152,0,0,0,0.140616785,0.2837414459947797
pit,Pittsburgh Steelers,16,Indianapolis Colts,28,24,26,354,332,22,0,21,365,238,127,2,1,1,0.140616785,0.2837414459947797
pit,Pittsburgh Steelers,17,Cleveland Browns,22,24,18,394,309,85,1,21,358,166,192,0,0,0,0.140616785,0.2837414459947797
nor,New Orleans Saints,1,Tampa Bay Buccaneers,34,23,18,271,189,82,0,23,310,224,86,3,1,1,0.14092679,0.3327286364279791
nor,New Orleans Saints,2,Las Vegas Raiders,24,34,26,424,312,112,1,28,377,261,116,1,0,0,0.14092679,0.3327286364279791
nor,New Orleans Saints,3,Green Bay Packers,30,37,21,397,275,122,1,24,369,271,98,0,0,1,0.14092679,0.3327286364279791
nor,New Orleans Saints,4,Detroit Lions,35,29,29,392,228,164,1,18,281,191,90,1,1,0,0.14092679,0.3327286364279791
nor,New Orleans Saints,5,Los Angeles Chargers,30,27,23,408,313,95,1,19,350,239,111,0,1,1,0.14092679,0.3327286364279791
nor,New Orleans Saints,7,Carolina Panthers,27,24,26,415,277,138,1,18,283,246,37,0,1,1,0.14092679,0.3327286364279791
nor,New Orleans Saints,8,Chicago Bears,26,23,23,394,272,122,0,18,329,233,96,1,1,0,0.14092679,0.3327286364279791
nor,New Orleans Saints,9,Tampa Bay Buccaneers,38,3,27,420,282,138,2,13,194,186,8,3,1,0,0.14092679,0.3327286364279791
nor,New Orleans Saints,10,San Francisco 49ers,27,13,17,237,123,114,2,21,281,232,49,4,1,1,0.14092679,0.3327286364279791
nor,New Orleans Saints,11,Atlanta Falcons,24,9,24,376,210,166,1,14,248,196,52,2,1,1,0.14092679,0.3327286364279791
nor,New Orleans Saints,12,Denver Broncos,31,3,19,292,63,229,1,6,112,12,100,3,1,0,0.14092679,0.3327286364279791
nor,New Orleans Saints,13,Atlanta Falcons,21,16,23,424,217,207,1,21,332,262,70,1,1,0,0.14092679,0.3327286364279791
nor,New Orleans Saints,14,Philadelphia Eagles,21,24,20,358,262,96,2,21,413,167,246,1,0,0,0.14092679,0.3327286364279791
nor,New Orleans Saints,15,Kansas City Chiefs,29,32,15,285,225,60,1,34,411,232,179,1,0,1,0.14092679,0.3327286364279791
nor,New Orleans Saints,16,Minnesota Vikings,52,33,36,583,319,264,2,25,364,274,90,0,1,1,0.14092679,0.3327286364279791
nor,New Orleans Saints,17,Carolina Panthers,33,7,20,347,191,156,0,17,320,246,74,5,1,0,0.14092679,0.3327286364279791
buf,Buffalo Bills,1,New York Jets,27,17,31,404,306,98,2,15,254,202,52,2,1,1,0.140788121,0.33213482760619456
buf,Buffalo Bills,2,Miami Dolphins,31,28,23,523,411,112,1,28,410,311,99,0,1,0,0.140788121,0.33213482760619456
buf,Buffalo Bills,3,Los Angeles Rams,35,32,23,375,274,101,2,28,478,311,167,2,1,1,0.140788121,0.33213482760619456
buf,Buffalo Bills,4,Las Vegas Raiders,30,23,21,337,274,63,0,24,383,297,86,2,1,0,0.140788121,0.33213482760619456
buf,Buffalo Bills,5,Tennessee Titans,16,42,23,370,275,95,3,25,334,195,139,0,0,0,0.140788121,0.33213482760619456
buf,Buffalo Bills,6,Kansas City Chiefs,17,26,20,206,122,84,1,27,466,221,245,1,0,1,0.140788121,0.33213482760619456
buf,Buffalo Bills,7,New York Jets,18,10,26,422,296,126,1,17,191,91,100,2,1,0,0.140788121,0.33213482760619456
buf,Buffalo Bills,8,New England Patriots,24,21,22,339,149,190,1,20,349,161,188,1,1,1,0.140788121,0.33213482760619456
buf,Buffalo Bills,9,Seattle Seahawks,44,34,27,420,386,34,0,22,419,362,57,4,1,1,0.140788121,0.33213482760619456
buf,Buffalo Bills,10,Arizona Cardinals,30,32,22,369,296,73,2,26,453,236,217,2,0,0,0.140788121,0.33213482760619456
buf,Buffalo Bills,12,Los Angeles Chargers,27,17,23,332,160,172,3,24,367,291,76,1,1,1,0.140788121,0.33213482760619456
buf,Buffalo Bills,13,San Francisco 49ers,34,24,31,449,368,81,1,24,402,316,86,2,1,0,0.140788121,0.33213482760619456
buf,Buffalo Bills,14,Pittsburgh Steelers,26,15,21,334,230,104,2,14,224,177,47,2,1,1,0.140788121,0.33213482760619456
buf,Buffalo Bills,15,Denver Broncos,48,19,29,534,352,182,1,19,255,115,140,1,1,0,0.140788121,0.33213482760619456
buf,Buffalo Bills,16,New England Patriots,38,9,31,474,344,130,0,11,201,56,145,0,1,0,0.140788121,0.33213482760619456
buf,Buffalo Bills,17,Miami Dolphins,56,26,24,455,377,78,2,27,454,384,70,4,1,1,0.140788121,0.33213482760619456
chi,Chicago Bears,1,Detroit Lions,27,23,26,363,214,149,0,25,426,288,138,1,1,0,0.139895399,0.2598264627610499
chi,Chicago Bears,2,New York Giants,17,13,18,304,169,135,2,22,295,220,75,2,1,1,0.139895399,0.2598264627610499
chi,Chicago Bears,3,Atlanta Falcons,30,26,24,437,307,130,2,22,371,227,144,1,1,0,0.139895399,0.2598264627610499
chi,Chicago Bears,4,Indianapolis Colts,11,19,16,269,241,28,1,18,289,186,103,0,0,1,0.139895399,0.2598264627610499
chi,Chicago Bears,5,Tampa Bay Buccaneers,20,19,18,243,208,35,1,18,339,233,106,1,1,1,0.139895399,0.2598264627610499
chi,Chicago Bears,6,Carolina Panthers,23,16,22,261,198,63,1,23,303,191,112,3,1,0,0.139895399,0.2598264627610499
chi,Chicago Bears,7,Los Angeles Rams,10,24,14,279,230,49,2,24,371,211,160,1,0,0,0.139895399,0.2598264627610499
chi,Chicago Bears,8,New Orleans Saints,23,26,18,329,233,96,1,23,394,272,122,0,0,1,0.139895399,0.2598264627610499
chi,Chicago Bears,9,Tennessee Titans,17,24,22,375,319,56,2,11,228,136,92,0,0,0,0.139895399,0.2598264627610499
chi,Chicago Bears,10,Minnesota Vikings,13,19,10,149,108,41,2,19,385,286,99,2,0,1,0.139895399,0.2598264627610499
chi,Chicago Bears,12,Green Bay Packers,25,41,26,350,229,121,3,28,393,211,182,0,0,0,0.139895399,0.2598264627610499
chi,Chicago Bears,13,Detroit Lions,30,34,26,389,249,140,1,24,460,400,60,1,0,1,0.139895399,0.2598264627610499
chi,Chicago Bears,14,Houston Texans,36,7,23,410,241,169,0,17,263,155,108,2,1,1,0.139895399,0.2598264627610499
chi,Chicago Bears,15,Minnesota Vikings,33,27,23,397,198,199,1,26,407,249,158,1,1,0,0.139895399,0.2598264627610499
chi,Chicago Bears,16,Jacksonville Jaguars,41,17,28,391,263,128,1,14,279,203,76,2,1,0,0.139895399,0.2598264627610499
chi,Chicago Bears,17,Green Bay Packers,16,35,21,356,248,108,2,17,316,237,79,1,0,1,0.139895399,0.2598264627610499
jax,Jacksonville Jaguars,1,Indianapolis Colts,27,20,17,241,150,91,0,27,445,357,88,2,1,1,0.138231925,0.20335546677135533
jax,Jacksonville Jaguars,2,Tennessee Titans,30,33,30,480,315,165,2,23,354,231,123,0,0,0,0.138231925,0.20335546677135533
jax,Jacksonville Jaguars,3,Miami Dolphins,13,31,22,318,246,72,2,23,294,156,138,0,0,1,0.138231925,0.20335546677135533
jax,Jacksonville Jaguars,4,Cincinnati Bengals,25,33,25,429,340,89,1,28,505,300,205,1,0,0,0.138231925,0.20335546677135533
jax,Jacksonville Jaguars,5,Houston Texans,14,30,22,364,289,75,2,24,486,357,129,2,0,0,0.138231925,0.20335546677135533
jax,Jacksonville Jaguars,6,Detroit Lions,16,34,16,275,231,44,2,25,403,223,180,1,0,1,0.138231925,0.20335546677135533
jax,Jacksonville Jaguars,7,Los Angeles Chargers,29,39,15,294,154,140,1,29,484,349,135,0,0,0,0.138231925,0.20335546677135533
jax,Jacksonville Jaguars,9,Houston Texans,25,27,22,403,288,115,1,19,374,267,107,1,0,1,0.138231925,0.20335546677135533
jax,Jacksonville Jaguars,10,Green Bay Packers,20,24,16,260,151,109,1,16,395,315,80,2,0,0,0.138231925,0.20335546677135533
jax,Jacksonville Jaguars,11,Pittsburgh Steelers,3,27,14,206,133,73,4,23,373,267,106,1,0,1,0.138231925,0.20335546677135533
jax,Jacksonville Jaguars,12,Cleveland Browns,25,27,22,375,235,140,0,25,459,252,207,1,0,1,0.138231925,0.20335546677135533
jax,Jacksonville Jaguars,13,Minnesota Vikings,24,27,20,390,266,124,4,30,420,275,145,2,0,0,0.138231925,0.20335546677135533
jax,Jacksonville Jaguars,14,Tennessee Titans,10,31,20,354,263,91,1,25,454,205,249,1,0,1,0.138231925,0.20335546677135533
jax,Jacksonville Jaguars,15,Baltimore Ravens,14,40,17,267,205,62,1,26,409,250,159,1,0,0,0.138231925,0.20335546677135533
jax,Jacksonville Jaguars,16,Chicago Bears,17,41,14,279,203,76,2,28,391,263,128,1,0,1,0.138231925,0.20335546677135533
jax,Jacksonville Jaguars,17,Indianapolis Colts,14,28,18,283,230,53,1,23,437,164,273,1,0,0,0.138231925,0.20335546677135533
mia,Miami Dolphins,1,New England Patriots,11,21,20,269,182,87,3,29,357,140,217,1,0,0,0.14032977800000002,0.2907303314522926
mia,Miami Dolphins,2,Buffalo Bills,28,31,28,410,311,99,0,23,523,411,112,1,0,1,0.14032977800000002,0.2907303314522926
mia,Miami Dolphins,3,Jacksonville Jaguars,31,13,23,294,156,138,0,22,318,246,72,2,1,0,0.14032977800000002,0.2907303314522926
mia,Miami Dolphins,4,Seattle Seahawks,23,31,25,415,312,103,2,26,441,343,98,1,0,1,0.14032977800000002,0.2907303314522926
mia,Miami Dolphins,5,San Francisco 49ers,43,17,22,436,342,94,0,19,259,128,131,3,1,0,0.14032977800000002,0.2907303314522926
mia,Miami Dolphins,6,New York Jets,24,0,18,302,192,110,2,13,263,148,115,1,1,1,0.14032977800000002,0.2907303314522926
mia,Miami Dolphins,8,Los Angeles Rams,28,17,8,145,90,55,2,31,471,340,131,4,1,1,0.14032977800000002,0.2907303314522926
mia,Miami Dolphins,9,Arizona Cardinals,34,31,24,312,221,91,0,26,442,264,178,1,1,0,0.14032977800000002,0.2907303314522926
mia,Miami Dolphins,10,Los Angeles Chargers,29,21,17,280,169,111,1,19,273,174,99,1,1,1,0.14032977800000002,0.2907303314522926
mia,Miami Dolphins,11,Denver Broncos,13,20,17,223,167,56,1,19,459,270,189,2,0,0,0.14032977800000002,0.2907303314522926
mia,Miami Dolphins,12,New York Jets,20,3,22,345,241,104,2,10,260,173,87,2,1,0,0.14032977800000002,0.2907303314522926
mia,Miami Dolphins,13,Cincinnati Bengals,19,7,23,406,296,110,1,12,196,156,40,2,1,1,0.14032977800000002,0.2907303314522926
mia,Miami Dolphins,14,Kansas City Chiefs,27,33,27,367,287,80,1,22,448,354,94,4,0,1,0.14032977800000002,0.2907303314522926
mia,Miami Dolphins,15,New England Patriots,22,12,26,383,133,250,1,18,303,186,117,1,1,1,0.14032977800000002,0.2907303314522926
mia,Miami Dolphins,16,Las Vegas Raiders,26,25,18,383,253,130,0,23,418,314,104,1,1,0,0.14032977800000002,0.2907303314522926
mia,Miami Dolphins,17,Buffalo Bills,26,56,27,454,384,70,4,24,455,377,78,2,0,0,0.14032977800000002,0.2907303314522926
htx,Houston Texans,1,Kansas City Chiefs,20,34,21,360,242,118,1,28,369,203,166,0,0,0,0.138984944,0.2418058059793673
htx,Houston Texans,2,Baltimore Ravens,16,33,18,304,253,51,2,23,407,177,230,0,0,1,0.138984944,0.2418058059793673
htx,Houston Texans,3,Pittsburgh Steelers,21,28,13,260,231,29,1,25,387,218,169,0,0,0,0.138984944,0.2418058059793673
htx,Houston Texans,4,Minnesota Vikings,23,31,20,386,290,96,1,24,410,248,162,0,0,1,0.138984944,0.2418058059793673
htx,Houston Texans,5,Jacksonville Jaguars,30,14,24,486,357,129,2,22,364,289,75,2,1,1,0.138984944,0.2418058059793673
htx,Houston Texans,6,Tennessee Titans,36,42,25,412,320,92,0,31,607,344,263,2,0,0,0.138984944,0.2418058059793673
htx,Houston Texans,7,Green Bay Packers,20,35,20,365,286,79,1,22,379,283,96,0,0,1,0.138984944,0.2418058059793673
htx,Houston Texans,9,Jacksonville Jaguars,27,25,19,374,267,107,1,22,403,288,115,1,1,0,0.138984944,0.2418058059793673
htx,Houston Texans,10,Cleveland Browns,7,10,16,243,153,90,0,20,356,125,231,0,0,0,0.138984944,0.2418058059793673
htx,Houston Texans,11,New England Patriots,27,20,21,399,344,55,0,22,435,349,86,0,1,1,0.138984944,0.2418058059793673
htx,Houston Texans,12,Detroit Lions,41,25,21,384,307,77,1,28,388,279,109,3,1,0,0.138984944,0.2418058059793673
htx,Houston Texans,13,Indianapolis Colts,20,26,20,398,308,90,2,25,371,262,109,0,0,1,0.138984944,0.2418058059793673
htx,Houston Texans,14,Chicago Bears,7,36,17,263,155,108,2,23,410,241,169,0,0,0,0.138984944,0.2418058059793673
htx,Houston Texans,15,Indianapolis Colts,20,27,22,425,342,83,2,20,350,223,127,0,0,0,0.138984944,0.2418058059793673
htx,Houston Texans,16,Cincinnati Bengals,31,37,23,488,322,166,1,27,540,371,169,0,0,1,0.138984944,0.2418058059793673
htx,Houston Texans,17,Tennessee Titans,38,41,26,457,361,96,1,28,492,204,288,1,0,1,0.138984944,0.2418058059793673
cin,Cincinnati Bengals,1,Los Angeles Chargers,13,16,19,295,173,122,2,19,362,207,155,0,0,1,0.139213577,0.2270290180665178
cin,Cincinnati Bengals,2,Cleveland Browns,30,35,30,353,285,68,1,23,434,219,215,1,0,0,0.139213577,0.2270290180665178
cin,Cincinnati Bengals,3,Philadelphia Eagles,23,23,24,304,256,48,0,27,381,206,175,2,0,0,0.139213577,0.2270290180665178
cin,Cincinnati Bengals,4,Jacksonville Jaguars,33,25,28,505,300,205,1,25,429,340,89,1,1,1,0.139213577,0.2270290180665178
cin,Cincinnati Bengals,5,Baltimore Ravens,3,27,12,205,135,70,3,17,332,171,161,1,0,0,0.139213577,0.2270290180665178
cin,Cincinnati Bengals,6,Indianapolis Colts,27,31,22,398,300,98,1,23,430,371,59,2,0,0,0.139213577,0.2270290180665178
cin,Cincinnati Bengals,7,Cleveland Browns,34,37,31,468,387,81,2,23,398,316,82,1,0,1,0.139213577,0.2270290180665178
cin,Cincinnati Bengals,8,Tennessee Titans,31,20,27,367,249,118,0,27,441,223,218,1,1,1,0.139213577,0.2270290180665178
cin,Cincinnati Bengals,10,Pittsburgh Steelers,10,36,16,324,185,139,2,22,377,333,44,0,0,0,0.139213577,0.2270290180665178
cin,Cincinnati Bengals,11,Washington Football Team,9,20,18,272,202,70,2,20,325,161,164,1,0,0,0.139213577,0.2270290180665178
cin,Cincinnati Bengals,12,New York Giants,17,19,11,155,115,40,3,19,386,244,142,1,0,1,0.139213577,0.2270290180665178
cin,Cincinnati Bengals,13,Miami Dolphins,7,19,12,196,156,40,2,23,406,296,110,1,0,0,0.139213577,0.2270290180665178
cin,Cincinnati Bengals,14,Dallas Cowboys,7,30,18,309,208,101,3,16,272,171,101,0,0,1,0.139213577,0.2270290180665178
cin,Cincinnati Bengals,15,Pittsburgh Steelers,27,17,13,230,78,152,0,12,244,158,86,3,1,1,0.139213577,0.2270290180665178
cin,Cincinnati Bengals,16,Houston Texans,37,31,27,540,371,169,0,23,488,322,166,1,1,0,0.139213577,0.2270290180665178
cin,Cincinnati Bengals,17,Baltimore Ravens,3,38,10,195,48,147,2,24,525,121,404,1,0,1,0.139213577,0.2270290180665178
crd,Arizona Cardinals,1,San Francisco 49ers,24,20,29,404,224,180,1,18,366,243,123,0,1,0,0.140344086,0.2801027929812861
crd,Arizona Cardinals,2,Washington Football Team,30,15,22,438,278,160,1,19,316,199,117,2,1,1,0.140344086,0.2801027929812861
crd,Arizona Cardinals,3,Detroit Lions,23,26,28,377,268,109,3,22,322,232,90,0,0,1,0.140344086,0.2801027929812861
crd,Arizona Cardinals,4,Carolina Panthers,21,31,21,262,133,129,1,30,444,276,168,1,0,0,0.140344086,0.2801027929812861
crd,Arizona Cardinals,5,New York Jets,30,10,28,496,369,127,1,21,285,162,123,0,1,0,0.140344086,0.2801027929812861
crd,Arizona Cardinals,6,Dallas Cowboys,38,10,22,438,177,261,0,27,344,247,97,4,1,0,0.140344086,0.2801027929812861
crd,Arizona Cardinals,7,Seattle Seahawks,37,34,31,519,360,159,2,33,572,372,200,3,1,1,0.140344086,0.2801027929812861
crd,Arizona Cardinals,9,Miami Dolphins,31,34,26,442,264,178,1,24,312,221,91,0,0,1,0.140344086,0.2801027929812861
crd,Arizona Cardinals,10,Buffalo Bills,32,30,26,453,236,217,2,22,369,296,73,2,1,1,0.140344086,0.2801027929812861
crd,Arizona Cardinals,11,Seattle Seahawks,21,28,24,314,257,57,0,22,347,182,165,0,0,0,0.140344086,0.2801027929812861
crd,Arizona Cardinals,12,New England Patriots,17,20,23,298,160,138,1,16,179,69,110,2,0,0,0.140344086,0.2801027929812861
crd,Arizona Cardinals,13,Los Angeles Rams,28,38,18,232,140,92,2,30,463,344,119,1,0,1,0.140344086,0.2801027929812861
crd,Arizona Cardinals,14,New York Giants,26,7,22,390,231,159,0,10,159,81,78,3,1,0,0.140344086,0.2801027929812861
crd,Arizona Cardinals,15,Philadelphia Eagles,33,26,26,526,423,103,3,26,422,305,117,0,1,1,0.140344086,0.2801027929812861
crd,Arizona Cardinals,16,San Francisco 49ers,12,20,20,350,230,120,2,22,398,171,227,1,0,1,0.140344086,0.2801027929812861
crd,Arizona Cardinals,17,Los Angeles Rams,7,18,15,214,166,48,1,21,333,223,110,2,0,0,0.140344086,0.2801027929812861
nwe,New England Patriots,1,Miami Dolphins,21,11,29,357,140,217,1,20,269,182,87,3,1,1,0.139777439,0.2672100873009487
nwe,New England Patriots,2,Seattle Seahawks,30,35,29,464,397,67,1,22,429,275,154,1,0,0,0.139777439,0.2672100873009487
nwe,New England Patriots,3,Las Vegas Raiders,36,20,25,406,156,250,1,22,375,249,126,3,1,1,0.139777439,0.2672100873009487
nwe,New England Patriots,4,Kansas City Chiefs,10,26,21,357,172,185,4,19,323,229,94,1,0,0,0.139777439,0.2672100873009487
nwe,New England Patriots,6,Denver Broncos,12,18,14,288,171,117,3,15,299,164,135,2,0,1,0.139777439,0.2672100873009487
nwe,New England Patriots,7,San Francisco 49ers,6,33,17,241,147,94,4,26,467,270,197,2,0,1,0.139777439,0.2672100873009487
nwe,New England Patriots,8,Buffalo Bills,21,24,20,349,161,188,1,22,339,149,190,1,0,0,0.139777439,0.2672100873009487
nwe,New England Patriots,9,New York Jets,30,27,30,433,274,159,0,18,322,257,65,1,1,0,0.139777439,0.2672100873009487
nwe,New England Patriots,10,Baltimore Ravens,23,17,25,308,135,173,0,19,357,242,115,1,1,1,0.139777439,0.2672100873009487
nwe,New England Patriots,11,Houston Texans,20,27,22,435,349,86,0,21,399,344,55,0,0,0,0.139777439,0.2672100873009487
nwe,New England Patriots,12,Arizona Cardinals,20,17,16,179,69,110,2,23,298,160,138,1,1,1,0.139777439,0.2672100873009487
nwe,New England Patriots,13,Los Angeles Chargers,45,0,22,291,126,165,0,17,258,188,70,2,1,0,0.139777439,0.2672100873009487
nwe,New England Patriots,14,Los Angeles Rams,3,24,10,220,113,107,1,17,318,132,186,1,0,0,0.139777439,0.2672100873009487
nwe,New England Patriots,15,Miami Dolphins,12,22,18,303,186,117,1,26,383,133,250,1,0,0,0.139777439,0.2672100873009487
nwe,New England Patriots,16,Buffalo Bills,9,38,11,201,56,145,0,31,474,344,130,0,0,1,0.139777439,0.2672100873009487
nwe,New England Patriots,17,New York Jets,28,14,23,404,238,166,0,21,350,239,111,2,1,1,0.139777439,0.2672100873009487
rai,Las Vegas Raiders,1,Carolina Panthers,34,30,23,372,239,133,0,22,388,259,129,0,1,0,0.139982265,0.2699992023521081
rai,Las Vegas Raiders,2,New Orleans Saints,34,24,28,377,261,116,1,26,424,312,112,1,1,1,0.139982265,0.2699992023521081
rai,Las Vegas Raiders,3,New England Patriots,20,36,22,375,249,126,3,25,406,156,250,1,0,0,0.139982265,0.2699992023521081
rai,Las Vegas Raiders,4,Buffalo Bills,23,30,24,383,297,86,2,21,337,274,63,0,0,1,0.139982265,0.2699992023521081
rai,Las Vegas Raiders,5,Kansas City Chiefs,40,32,22,490,346,144,1,21,413,333,80,1,1,0,0.139982265,0.2699992023521081
rai,Las Vegas Raiders,7,Tampa Bay Buccaneers,20,45,19,347,271,76,1,29,454,369,85,0,0,1,0.139982265,0.2699992023521081
rai,Las Vegas Raiders,8,Cleveland Browns,16,6,24,309,100,209,0,14,223,122,101,1,1,0,0.139982265,0.2699992023521081
rai,Las Vegas Raiders,9,Los Angeles Chargers,31,26,16,320,160,160,1,26,440,312,128,1,1,0,0.139982265,0.2699992023521081
rai,Las Vegas Raiders,10,Denver Broncos,37,12,21,357,154,203,0,20,313,247,66,5,1,1,0.139982265,0.2699992023521081
rai,Las Vegas Raiders,11,Kansas City Chiefs,31,35,25,364,275,89,1,36,460,352,108,1,0,1,0.139982265,0.2699992023521081
rai,Las Vegas Raiders,12,Atlanta Falcons,6,43,13,243,203,40,5,23,304,179,125,1,0,0,0.139982265,0.2699992023521081
rai,Las Vegas Raiders,13,New York Jets,31,28,24,440,368,72,2,24,376,170,206,3,1,0,0.139982265,0.2699992023521081
rai,Las Vegas Raiders,14,Indianapolis Colts,27,44,26,424,345,79,3,25,456,244,212,0,0,1,0.139982265,0.2699992023521081
rai,Las Vegas Raiders,15,Los Angeles Chargers,27,30,27,449,276,173,1,27,402,306,96,0,0,1,0.139982265,0.2699992023521081
rai,Las Vegas Raiders,16,Miami Dolphins,25,26,23,418,314,104,1,18,383,253,130,0,0,1,0.139982265,0.2699992023521081
rai,Las Vegas Raiders,17,Denver Broncos,32,31,22,465,359,106,4,24,446,324,122,0,1,0,0.139982265,0.2699992023521081
cle,Cleveland Browns,1,Baltimore Ravens,6,38,20,306,168,138,3,23,381,270,111,1,0,0,0.139760851,0.269047439435198
cle,Cleveland Browns,2,Cincinnati Bengals,35,30,23,434,219,215,1,30,353,285,68,1,1,1,0.139760851,0.269047439435198
cle,Cleveland Browns,3,Washington Football Team,34,20,19,300,142,158,0,19,309,206,103,5,1,1,0.139760851,0.269047439435198
cle,Cleveland Browns,4,Dallas Cowboys,49,38,33,508,201,307,0,35,566,481,85,3,1,0,0.139760851,0.269047439435198
cle,Cleveland Browns,5,Indianapolis Colts,32,23,22,385,261,124,2,15,308,240,68,2,1,1,0.139760851,0.269047439435198
cle,Cleveland Browns,6,Pittsburgh Steelers,7,38,12,220,145,75,2,18,277,148,129,0,0,0,0.139760851,0.269047439435198
cle,Cleveland Browns,7,Cincinnati Bengals,37,34,23,398,316,82,1,31,468,387,81,2,1,0,0.139760851,0.269047439435198
cle,Cleveland Browns,8,Las Vegas Raiders,6,16,14,223,122,101,1,24,309,100,209,0,0,1,0.139760851,0.269047439435198
cle,Cleveland Browns,10,Houston Texans,10,7,20,356,125,231,0,16,243,153,90,0,1,1,0.139760851,0.269047439435198
cle,Cleveland Browns,11,Philadelphia Eagles,22,17,17,324,187,137,1,19,315,209,106,3,1,1,0.139760851,0.269047439435198
cle,Cleveland Browns,12,Jacksonville Jaguars,27,25,25,459,252,207,1,22,375,235,140,0,1,0,0.139760851,0.269047439435198
cle,Cleveland Browns,13,Tennessee Titans,41,35,26,458,340,118,1,25,431,369,62,3,1,0,0.139760851,0.269047439435198
cle,Cleveland Browns,14,Baltimore Ravens,42,47,33,493,355,138,1,25,385,154,231,0,0,1,0.139760851,0.269047439435198
cle,Cleveland Browns,15,New York Giants,20,6,24,392,286,106,0,14,288,214,74,0,1,0,0.139760851,0.269047439435198
cle,Cleveland Browns,16,New York Jets,16,23,23,299,254,45,2,18,333,202,131,0,0,0,0.139760851,0.269047439435198
cle,Cleveland Browns,17,Pittsburgh Steelers,24,22,21,358,166,192,0,18,394,309,85,1,1,1,0.139760851,0.269047439435198
sea,Seattle Seahawks,1,Atlanta Falcons,38,25,22,383,299,84,0,28,506,434,72,2,1,0,0.140382496,0.2971209484610509
sea,Seattle Seahawks,2,New England Patriots,35,30,22,429,275,154,1,29,464,397,67,1,1,1,0.140382496,0.2971209484610509
sea,Seattle Seahawks,3,Dallas Cowboys,38,31,23,412,295,117,1,27,522,461,61,3,1,1,0.140382496,0.2971209484610509
sea,Seattle Seahawks,4,Miami Dolphins,31,23,26,441,343,98,1,25,415,312,103,2,1,0,0.140382496,0.2971209484610509
sea,Seattle Seahawks,5,Minnesota Vikings,27,26,18,314,190,124,1,31,449,248,201,2,1,1,0.140382496,0.2971209484610509
sea,Seattle Seahawks,7,Arizona Cardinals,34,37,33,572,372,200,3,31,519,360,159,2,0,0,0.140382496,0.2971209484610509
sea,Seattle Seahawks,8,San Francisco 49ers,37,27,27,350,249,101,0,24,351,299,52,2,1,1,0.140382496,0.2971209484610509
sea,Seattle Seahawks,9,Buffalo Bills,34,44,22,419,362,57,4,27,420,386,34,0,0,0,0.140382496,0.2971209484610509
sea,Seattle Seahawks,10,Los Angeles Rams,16,23,20,333,220,113,3,24,389,283,106,1,0,0,0.140382496,0.2971209484610509
sea,Seattle Seahawks,11,Arizona Cardinals,28,21,22,347,182,165,0,24,314,257,57,0,1,1,0.140382496,0.2971209484610509
sea,Seattle Seahawks,12,Philadelphia Eagles,23,17,20,301,225,76,0,18,250,180,70,1,1,0,0.140382496,0.2971209484610509
sea,Seattle Seahawks,13,New York Giants,12,17,21,327,216,111,2,13,290,100,190,1,0,1,0.140382496,0.2971209484610509
sea,Seattle Seahawks,14,New York Jets,40,3,28,410,236,174,1,12,185,116,69,1,1,1,0.140382496,0.2971209484610509
sea,Seattle Seahawks,15,Washington Football Team,20,15,16,302,121,181,1,26,353,269,84,2,1,0,0.140382496,0.2971209484610509
sea,Seattle Seahawks,16,Los Angeles Rams,20,9,15,292,197,95,0,20,334,216,118,1,1,1,0.140382496,0.2971209484610509
sea,Seattle Seahawks,17,San Francisco 49ers,26,23,21,280,159,121,0,17,328,242,86,1,1,0,0.140382496,0.2971209484610509
sdg,Los Angeles Chargers,1,Cincinnati Bengals,16,13,19,362,207,155,0,19,295,173,122,2,1,0,0.13993824,0.26421283672060464
sdg,Los Angeles Chargers,2,Kansas City Chiefs,20,23,28,479,296,183,1,23,414,289,125,0,0,1,0.13993824,0.26421283672060464
sdg,Los Angeles Chargers,3,Carolina Panthers,16,21,26,436,319,117,4,14,302,221,81,0,0,1,0.13993824,0.26421283672060464
sdg,Los Angeles Chargers,4,Tampa Bay Buccaneers,31,38,15,324,278,46,2,28,484,369,115,1,0,0,0.13993824,0.26421283672060464
sdg,Los Angeles Chargers,5,New Orleans Saints,27,30,19,350,239,111,0,23,408,313,95,1,0,0,0.13993824,0.26421283672060464
sdg,Los Angeles Chargers,7,Jacksonville Jaguars,39,29,29,484,349,135,0,15,294,154,140,1,1,1,0.13993824,0.26421283672060464
sdg,Los Angeles Chargers,8,Denver Broncos,30,31,28,485,275,210,2,17,351,243,108,1,0,0,0.13993824,0.26421283672060464
sdg,Los Angeles Chargers,9,Las Vegas Raiders,26,31,26,440,312,128,1,16,320,160,160,1,0,1,0.13993824,0.26421283672060464
sdg,Los Angeles Chargers,10,Miami Dolphins,21,29,19,273,174,99,1,17,280,169,111,1,0,0,0.13993824,0.26421283672060464
sdg,Los Angeles Chargers,11,New York Jets,34,28,28,376,347,29,1,20,292,196,96,1,1,1,0.13993824,0.26421283672060464
sdg,Los Angeles Chargers,12,Buffalo Bills,17,27,24,367,291,76,1,23,332,160,172,3,0,0,0.13993824,0.26421283672060464
sdg,Los Angeles Chargers,13,New England Patriots,0,45,17,258,188,70,2,22,291,126,165,0,0,1,0.13993824,0.26421283672060464
sdg,Los Angeles Chargers,14,Atlanta Falcons,20,17,23,345,240,105,1,19,319,249,70,3,1,1,0.13993824,0.26421283672060464
sdg,Los Angeles Chargers,15,Las Vegas Raiders,30,27,27,402,306,96,0,27,449,276,173,1,1,0,0.13993824,0.26421283672060464
sdg,Los Angeles Chargers,16,Denver Broncos,19,16,16,316,227,89,0,23,396,263,133,2,1,1,0.13993824,0.26421283672060464
sdg,Los Angeles Chargers,17,Kansas City Chiefs,38,21,29,416,281,135,0,18,268,217,51,1,1,0,0.13993824,0.26421283672060464
tam,Tampa Bay Buccaneers,1,New Orleans Saints,23,34,23,310,224,86,3,18,271,189,82,0,0,0,0.140707937,0.2962225875540581
tam,Tampa Bay Buccaneers,2,Carolina Panthers,31,17,20,339,217,122,2,24,427,340,87,4,1,1,0.140707937,0.2962225875540581
tam,Tampa Bay Buccaneers,3,Denver Broncos,28,10,17,353,285,68,0,13,226,184,42,2,1,0,0.140707937,0.2962225875540581
tam,Tampa Bay Buccaneers,4,Los Angeles Chargers,38,31,28,484,369,115,1,15,324,278,46,2,1,1,0.140707937,0.2962225875540581
tam,Tampa Bay Buccaneers,5,Chicago Bears,19,20,18,339,233,106,1,18,243,208,35,1,0,0,0.140707937,0.2962225875540581
tam,Tampa Bay Buccaneers,6,Green Bay Packers,38,10,21,324,166,158,0,13,201,107,94,2,1,1,0.140707937,0.2962225875540581
tam,Tampa Bay Buccaneers,7,Las Vegas Raiders,45,20,29,454,369,85,0,19,347,271,76,1,1,0,0.140707937,0.2962225875540581
tam,Tampa Bay Buccaneers,8,New York Giants,25,23,23,344,263,81,1,24,357,256,101,2,1,0,0.140707937,0.2962225875540581
tam,Tampa Bay Buccaneers,9,New Orleans Saints,3,38,13,194,186,8,3,27,420,282,138,2,0,1,0.140707937,0.2962225875540581
tam,Tampa Bay Buccaneers,10,Carolina Panthers,46,23,30,544,334,210,1,13,187,122,65,1,1,0,0.140707937,0.2962225875540581
tam,Tampa Bay Buccaneers,11,Los Angeles Rams,24,27,20,251,209,42,2,22,413,376,37,2,0,1,0.140707937,0.2962225875540581
tam,Tampa Bay Buccaneers,12,Kansas City Chiefs,24,27,20,417,342,75,2,26,543,456,87,1,0,1,0.140707937,0.2962225875540581
tam,Tampa Bay Buccaneers,14,Minnesota Vikings,26,14,17,303,196,107,0,27,335,173,162,1,1,1,0.140707937,0.2962225875540581
tam,Tampa Bay Buccaneers,15,Atlanta Falcons,31,27,27,416,365,51,0,23,369,332,37,0,1,0,0.140707937,0.2962225875540581
tam,Tampa Bay Buccaneers,16,Detroit Lions,47,7,30,588,477,111,0,12,186,113,73,2,1,0,0.140707937,0.2962225875540581
tam,Tampa Bay Buccaneers,17,Atlanta Falcons,44,27,28,485,391,94,1,25,385,258,127,2,1,1,0.140707937,0.2962225875540581
sfo,San Francisco 49ers,1,Arizona Cardinals,20,24,18,366,243,123,0,29,404,224,180,1,0,1,0.140171275,0.2567038230460543
sfo,San Francisco 49ers,2,New York Jets,31,13,17,359,177,182,1,17,277,173,104,0,1,0,0.140171275,0.2567038230460543
sfo,San Francisco 49ers,3,New York Giants,36,9,29,420,327,93,0,13,231,165,66,3,1,0,0.140171275,0.2567038230460543
sfo,San Francisco 49ers,4,Philadelphia Eagles,20,25,25,417,301,116,3,18,267,174,93,1,0,1,0.140171275,0.2567038230460543
sfo,San Francisco 49ers,5,Miami Dolphins,17,43,19,259,128,131,3,22,436,342,94,0,0,1,0.140171275,0.2567038230460543
sfo,San Francisco 49ers,6,Los Angeles Rams,24,16,24,390,268,122,0,17,311,198,113,1,1,1,0.140171275,0.2567038230460543
sfo,San Francisco 49ers,7,New England Patriots,33,6,26,467,270,197,2,17,241,147,94,4,1,0,0.140171275,0.2567038230460543
sfo,San Francisco 49ers,8,Seattle Seahawks,27,37,24,351,299,52,2,27,350,249,101,0,0,0,0.140171275,0.2567038230460543
sfo,San Francisco 49ers,9,Green Bay Packers,17,34,17,337,282,55,2,21,405,294,111,0,0,1,0.140171275,0.2567038230460543
sfo,San Francisco 49ers,10,New Orleans Saints,13,27,21,281,232,49,4,17,237,123,114,2,0,0,0.140171275,0.2567038230460543
sfo,San Francisco 49ers,12,Los Angeles Rams,23,20,18,345,233,112,3,14,308,182,126,4,1,0,0.140171275,0.2567038230460543
sfo,San Francisco 49ers,13,Buffalo Bills,24,34,24,402,316,86,2,31,449,368,81,1,0,1,0.140171275,0.2567038230460543
sfo,San Francisco 49ers,14,Washington Football Team,15,23,21,344,236,108,3,12,193,95,98,1,0,1,0.140171275,0.2567038230460543
sfo,San Francisco 49ers,15,Dallas Cowboys,33,41,28,458,308,150,4,15,291,204,87,0,0,0,0.140171275,0.2567038230460543
sfo,San Francisco 49ers,16,Arizona Cardinals,20,12,22,398,171,227,1,20,350,230,120,2,1,0,0.140171275,0.2567038230460543
sfo,San Francisco 49ers,17,Seattle Seahawks,23,26,17,328,242,86,1,21,280,159,121,0,0,1,0.140171275,0.2567038230460543
den,Denver Broncos,1,Tennessee Titans,14,16,19,323,216,107,1,26,377,247,130,0,0,1,0.13895022699999998,0.19695726040607456
den,Denver Broncos,2,Pittsburgh Steelers,21,26,23,319,215,104,2,19,410,301,109,2,0,0,0.13895022699999998,0.19695726040607456
den,Denver Broncos,3,Tampa Bay Buccaneers,10,28,13,226,184,42,2,17,353,285,68,0,0,1,0.13895022699999998,0.19695726040607456
den,Denver Broncos,4,New York Jets,37,28,21,359,242,117,3,18,321,192,129,0,1,0,0.13895022699999998,0.19695726040607456
den,Denver Broncos,6,New England Patriots,18,12,15,299,164,135,2,14,288,171,117,3,1,0,0.13895022699999998,0.19695726040607456
den,Denver Broncos,7,Kansas City Chiefs,16,43,24,411,234,177,4,17,286,185,101,1,0,1,0.13895022699999998,0.19695726040607456
den,Denver Broncos,8,Los Angeles Chargers,31,30,17,351,243,108,1,28,485,275,210,2,1,1,0.13895022699999998,0.19695726040607456
den,Denver Broncos,9,Atlanta Falcons,27,34,23,405,302,103,1,23,363,271,92,1,0,0,0.13895022699999998,0.19695726040607456
den,Denver Broncos,10,Las Vegas Raiders,12,37,20,313,247,66,5,21,357,154,203,0,0,0,0.13895022699999998,0.19695726040607456
den,Denver Broncos,11,Miami Dolphins,20,13,19,459,270,189,2,17,223,167,56,1,1,1,0.13895022699999998,0.19695726040607456
den,Denver Broncos,12,New Orleans Saints,3,31,6,112,12,100,3,19,292,63,229,1,0,1,0.13895022699999998,0.19695726040607456
den,Denver Broncos,13,Kansas City Chiefs,16,22,19,330,151,179,2,25,447,313,134,0,0,0,0.13895022699999998,0.19695726040607456
den,Denver Broncos,14,Carolina Panthers,32,27,23,365,269,96,1,22,370,245,125,0,1,0,0.13895022699999998,0.19695726040607456
den,Denver Broncos,15,Buffalo Bills,19,48,19,255,115,140,1,29,534,352,182,1,0,1,0.13895022699999998,0.19695726040607456
den,Denver Broncos,16,Los Angeles Chargers,16,19,23,396,263,133,2,16,316,227,89,0,0,0,0.13895022699999998,0.19695726040607456
den,Denver Broncos,17,Las Vegas Raiders,31,32,24,446,324,122,0,22,465,359,106,4,0,1,0.13895022699999998,0.19695726040607456
clt,Indianapolis Colts,1,Jacksonville Jaguars,20,27,27,445,357,88,2,17,241,150,91,0,0,0,0.140791513,0.3099392481927539
clt,Indianapolis Colts,2,Minnesota Vikings,28,11,24,354,203,151,1,12,175,95,80,3,1,1,0.140791513,0.3099392481927539
clt,Indianapolis Colts,3,New York Jets,36,7,21,353,234,119,0,15,260,151,109,3,1,1,0.140791513,0.3099392481927539
clt,Indianapolis Colts,4,Chicago Bears,19,11,18,289,186,103,0,16,269,241,28,1,1,0,0.140791513,0.3099392481927539
clt,Indianapolis Colts,5,Cleveland Browns,23,32,15,308,240,68,2,22,385,261,124,2,0,0,0.140791513,0.3099392481927539
clt,Indianapolis Colts,6,Cincinnati Bengals,31,27,23,430,371,59,2,22,398,300,98,1,1,1,0.140791513,0.3099392481927539
clt,Indianapolis Colts,8,Detroit Lions,41,21,26,366,247,119,0,20,326,297,29,2,1,0,0.140791513,0.3099392481927539
clt,Indianapolis Colts,9,Baltimore Ravens,10,24,20,339,227,112,2,19,266,156,110,1,0,1,0.140791513,0.3099392481927539
clt,Indianapolis Colts,10,Tennessee Titans,34,17,26,430,297,133,0,25,294,137,157,0,1,0,0.140791513,0.3099392481927539
clt,Indianapolis Colts,11,Green Bay Packers,34,31,23,420,280,140,2,21,367,301,66,4,1,1,0.140791513,0.3099392481927539
clt,Indianapolis Colts,12,Tennessee Titans,26,45,27,336,280,56,1,28,449,220,229,0,0,1,0.140791513,0.3099392481927539
clt,Indianapolis Colts,13,Houston Texans,26,20,25,371,262,109,0,20,398,308,90,2,1,0,0.140791513,0.3099392481927539
clt,Indianapolis Colts,14,Las Vegas Raiders,44,27,25,456,244,212,0,26,424,345,79,3,1,0,0.140791513,0.3099392481927539
clt,Indianapolis Colts,15,Houston Texans,27,20,20,350,223,127,0,22,425,342,83,2,1,1,0.140791513,0.3099392481927539
clt,Indianapolis Colts,16,Pittsburgh Steelers,24,28,21,365,238,127,2,26,354,332,22,0,0,0,0.140791513,0.3099392481927539
clt,Indianapolis Colts,17,Jacksonville Jaguars,28,14,23,437,164,273,1,18,283,230,53,1,1,1,0.140791513,0.3099392481927539
car,Carolina Panthers,1,Las Vegas Raiders,30,34,22,388,259,129,0,23,372,239,133,0,0,1,0.139550962,0.2642330574164929
car,Carolina Panthers,2,Tampa Bay Buccaneers,17,31,24,427,340,87,4,20,339,217,122,2,0,0,0.139550962,0.2642330574164929
car,Carolina Panthers,3,Los Angeles Chargers,21,16,14,302,221,81,0,26,436,319,117,4,1,0,0.139550962,0.2642330574164929
car,Carolina Panthers,4,Arizona Cardinals,31,21,30,444,276,168,1,21,262,133,129,1,1,1,0.139550962,0.2642330574164929
car,Carolina Panthers,5,Atlanta Falcons,23,16,24,437,313,124,0,21,373,207,166,1,1,0,0.139550962,0.2642330574164929
car,Carolina Panthers,6,Chicago Bears,16,23,23,303,191,112,3,22,261,198,63,1,0,1,0.139550962,0.2642330574164929
car,Carolina Panthers,7,New Orleans Saints,24,27,18,283,246,37,0,26,415,277,138,1,0,0,0.139550962,0.2642330574164929
car,Carolina Panthers,8,Atlanta Falcons,17,25,18,304,157,147,1,28,401,270,131,1,0,1,0.139550962,0.2642330574164929
car,Carolina Panthers,9,Kansas City Chiefs,31,33,30,435,331,104,0,24,397,361,36,1,0,0,0.139550962,0.2642330574164929
car,Carolina Panthers,10,Tampa Bay Buccaneers,23,46,13,187,122,65,1,30,544,334,210,1,0,1,0.139550962,0.2642330574164929
car,Carolina Panthers,11,Detroit Lions,20,0,20,374,258,116,2,10,185,145,40,1,1,1,0.139550962,0.2642330574164929
car,Carolina Panthers,12,Minnesota Vikings,27,28,21,374,267,107,1,26,387,291,96,3,0,0,0.139550962,0.2642330574164929
car,Carolina Panthers,14,Denver Broncos,27,32,22,370,245,125,0,23,365,269,96,1,0,1,0.139550962,0.2642330574164929
car,Carolina Panthers,15,Green Bay Packers,16,24,20,364,249,115,1,20,291,96,195,0,0,0,0.139550962,0.2642330574164929
car,Carolina Panthers,16,Washington Football Team,20,13,19,280,167,113,2,20,386,278,108,4,1,0,0.139550962,0.2642330574164929
car,Carolina Panthers,17,New Orleans Saints,7,33,17,320,246,74,5,20,347,191,156,0,0,1,0.139550962,0.2642330574164929
oti,Tennessee Titans,1,Denver Broncos,16,14,26,377,247,130,0,19,323,216,107,1,1,0,0.140009717,0.27979467663046864
oti,Tennessee Titans,2,Jacksonville Jaguars,33,30,23,354,231,123,0,30,480,315,165,2,1,1,0.140009717,0.27979467663046864
oti,Tennessee Titans,3,Minnesota Vikings,31,30,23,444,310,134,1,22,464,238,226,3,1,0,0.140009717,0.27979467663046864
oti,Tennessee Titans,5,Buffalo Bills,42,16,25,334,195,139,0,23,370,275,95,3,1,1,0.140009717,0.27979467663046864
oti,Tennessee Titans,6,Houston Texans,42,36,31,607,344,263,2,25,412,320,92,0,1,1,0.140009717,0.27979467663046864
oti,Tennessee Titans,7,Pittsburgh Steelers,24,27,15,292,210,82,0,23,362,268,94,3,0,1,0.140009717,0.27979467663046864
oti,Tennessee Titans,8,Cincinnati Bengals,20,31,27,441,223,218,1,27,367,249,118,0,0,0,0.140009717,0.27979467663046864
oti,Tennessee Titans,9,Chicago Bears,24,17,11,228,136,92,0,22,375,319,56,2,1,1,0.140009717,0.27979467663046864
oti,Tennessee Titans,10,Indianapolis Colts,17,34,25,294,137,157,0,26,430,297,133,0,0,1,0.140009717,0.27979467663046864
oti,Tennessee Titans,11,Baltimore Ravens,30,24,26,423,250,173,1,21,306,177,129,1,1,0,0.140009717,0.27979467663046864
oti,Tennessee Titans,12,Indianapolis Colts,45,26,28,449,220,229,0,27,336,280,56,1,1,0,0.140009717,0.27979467663046864
oti,Tennessee Titans,13,Cleveland Browns,35,41,25,431,369,62,3,26,458,340,118,1,0,1,0.140009717,0.27979467663046864
oti,Tennessee Titans,14,Jacksonville Jaguars,31,10,25,454,205,249,1,20,354,263,91,1,1,0,0.140009717,0.27979467663046864
oti,Tennessee Titans,15,Detroit Lions,46,25,28,463,268,195,0,27,430,307,123,3,1,1,0.140009717,0.27979467663046864
oti,Tennessee Titans,16,Green Bay Packers,14,40,15,260,104,156,2,27,448,214,234,1,0,0,0.140009717,0.27979467663046864
oti,Tennessee Titans,17,Houston Texans,41,38,28,492,204,288,1,26,457,361,96,1,1,0,0.140009717,0.27979467663046864
kan,Kansas City Chiefs,1,Houston Texans,34,20,28,369,203,166,0,21,360,242,118,1,1,1,0.141070642,0.32701629339957217
kan,Kansas City Chiefs,2,Los Angeles Chargers,23,20,23,414,289,125,0,28,479,296,183,1,1,0,0.141070642,0.32701629339957217
kan,Kansas City Chiefs,3,Baltimore Ravens,34,20,29,517,385,132,1,16,228,70,158,1,1,0,0.141070642,0.32701629339957217
kan,Kansas City Chiefs,4,New England Patriots,26,10,19,323,229,94,1,21,357,172,185,4,1,1,0.141070642,0.32701629339957217
kan,Kansas City Chiefs,5,Las Vegas Raiders,32,40,21,413,333,80,1,22,490,346,144,1,0,1,0.141070642,0.32701629339957217
kan,Kansas City Chiefs,6,Buffalo Bills,26,17,27,466,221,245,1,20,206,122,84,1,1,0,0.141070642,0.32701629339957217
kan,Kansas City Chiefs,7,Denver Broncos,43,16,17,286,185,101,1,24,411,234,177,4,1,0,0.141070642,0.32701629339957217
kan,Kansas City Chiefs,8,New York Jets,35,9,25,496,446,50,0,13,221,128,93,1,1,1,0.141070642,0.32701629339957217
kan,Kansas City Chiefs,9,Carolina Panthers,33,31,24,397,361,36,1,30,435,331,104,0,1,1,0.141070642,0.32701629339957217
kan,Kansas City Chiefs,11,Las Vegas Raiders,35,31,36,460,352,108,1,25,364,275,89,1,1,0,0.141070642,0.32701629339957217
kan,Kansas City Chiefs,12,Tampa Bay Buccaneers,27,24,26,543,456,87,1,20,417,342,75,2,1,0,0.141070642,0.32701629339957217
kan,Kansas City Chiefs,13,Denver Broncos,22,16,25,447,313,134,0,19,330,151,179,2,1,1,0.141070642,0.32701629339957217
kan,Kansas City Chiefs,14,Miami Dolphins,33,27,22,448,354,94,4,27,367,287,80,1,1,0,0.141070642,0.32701629339957217
kan,Kansas City Chiefs,15,New Orleans Saints,32,29,34,411,232,179,1,15,285,225,60,1,1,0,0.141070642,0.32701629339957217
kan,Kansas City Chiefs,16,Atlanta Falcons,17,14,23,395,278,117,2,23,367,277,90,1,1,1,0.141070642,0.32701629339957217
kan,Kansas City Chiefs,17,Los Angeles Chargers,21,38,18,268,217,51,1,29,416,281,135,0,0,1,0.141070642,0.32701629339957217
ram,Los Angeles Rams,1,Dallas Cowboys,20,17,23,422,269,153,1,24,380,244,136,0,1,1,0.140892984,0.3045586975607479
ram,Los Angeles Rams,2,Philadelphia Eagles,37,19,30,449,258,191,1,25,363,242,121,3,1,0,0.140892984,0.3045586975607479
ram,Los Angeles Rams,3,Buffalo Bills,32,35,28,478,311,167,2,23,375,274,101,2,0,0,0.140892984,0.3045586975607479
ram,Los Angeles Rams,4,New York Giants,17,9,15,240,182,58,1,19,295,159,136,1,1,1,0.140892984,0.3045586975607479
ram,Los Angeles Rams,5,Washington Football Team,30,10,20,429,300,129,1,10,108,70,38,0,1,0,0.140892984,0.3045586975607479
ram,Los Angeles Rams,6,San Francisco 49ers,16,24,17,311,198,113,1,24,390,268,122,0,0,0,0.140892984,0.3045586975607479
ram,Los Angeles Rams,7,Chicago Bears,24,10,24,371,211,160,1,14,279,230,49,2,1,1,0.140892984,0.3045586975607479
ram,Los Angeles Rams,8,Miami Dolphins,17,28,31,471,340,131,4,8,145,90,55,2,0,0,0.140892984,0.3045586975607479
ram,Los Angeles Rams,10,Seattle Seahawks,23,16,24,389,283,106,1,20,333,220,113,3,1,1,0.140892984,0.3045586975607479
ram,Los Angeles Rams,11,Tampa Bay Buccaneers,27,24,22,413,376,37,2,20,251,209,42,2,1,0,0.140892984,0.3045586975607479
ram,Los Angeles Rams,12,San Francisco 49ers,20,23,14,308,182,126,4,18,345,233,112,3,0,1,0.140892984,0.3045586975607479
ram,Los Angeles Rams,13,Arizona Cardinals,38,28,30,463,344,119,1,18,232,140,92,2,1,0,0.140892984,0.3045586975607479
ram,Los Angeles Rams,14,New England Patriots,24,3,17,318,132,186,1,10,220,113,107,1,1,1,0.140892984,0.3045586975607479
ram,Los Angeles Rams,15,New York Jets,20,23,16,303,189,114,1,17,289,196,93,0,0,1,0.140892984,0.3045586975607479
ram,Los Angeles Rams,16,Seattle Seahawks,9,20,20,334,216,118,1,15,292,197,95,0,0,0,0.140892984,0.3045586975607479
ram,Los Angeles Rams,17,Arizona Cardinals,18,7,21,333,223,110,2,15,214,166,48,1,1,1,0.140892984,0.3045586975607479
rav,Baltimore Ravens,1,Cleveland Browns,38,6,23,381,270,111,1,20,306,168,138,3,1,1,0.140093307,0.28601494233006913
rav,Baltimore Ravens,2,Houston Texans,33,16,23,407,177,230,0,18,304,253,51,2,1,0,0.140093307,0.28601494233006913
rav,Baltimore Ravens,3,Kansas City Chiefs,20,34,16,228,70,158,1,29,517,385,132,1,0,1,0.140093307,0.28601494233006913
rav,Baltimore Ravens,4,Washington Football Team,31,17,18,350,206,144,2,24,343,274,69,1,1,0,0.140093307,0.28601494233006913
rav,Baltimore Ravens,5,Cincinnati Bengals,27,3,17,332,171,161,1,12,205,135,70,3,1,1,0.140093307,0.28601494233006913
rav,Baltimore Ravens,6,Philadelphia Eagles,30,28,17,355,173,182,0,19,364,170,194,1,1,0,0.140093307,0.28601494233006913
rav,Baltimore Ravens,8,Pittsburgh Steelers,24,28,25,457,192,265,4,19,221,173,48,1,0,1,0.140093307,0.28601494233006913
rav,Baltimore Ravens,9,Indianapolis Colts,24,10,19,266,156,110,1,20,339,227,112,2,1,0,0.140093307,0.28601494233006913
rav,Baltimore Ravens,10,New England Patriots,17,23,19,357,242,115,1,25,308,135,173,0,0,0,0.140093307,0.28601494233006913
rav,Baltimore Ravens,11,Tennessee Titans,24,30,21,306,177,129,1,26,423,250,173,1,0,1,0.140093307,0.28601494233006913
rav,Baltimore Ravens,12,Pittsburgh Steelers,14,19,10,219,90,129,2,22,334,266,68,2,0,0,0.140093307,0.28601494233006913
rav,Baltimore Ravens,13,Dallas Cowboys,34,17,19,401,107,294,1,29,388,277,111,1,1,1,0.140093307,0.28601494233006913
rav,Baltimore Ravens,14,Cleveland Browns,47,42,25,385,154,231,0,33,493,355,138,1,1,0,0.140093307,0.28601494233006913
rav,Baltimore Ravens,15,Jacksonville Jaguars,40,14,26,409,250,159,1,17,267,205,62,1,1,1,0.140093307,0.28601494233006913
rav,Baltimore Ravens,16,New York Giants,27,13,25,432,183,249,1,24,269,215,54,0,1,1,0.140093307,0.28601494233006913
rav,Baltimore Ravens,17,Cincinnati Bengals,38,3,24,525,121,404,1,10,195,48,147,2,1,0,0.140093307,0.28601494233006913
gnb,Green Bay Packers,1,Minnesota Vikings,43,34,31,522,364,158,0,25,382,248,134,1,1,0,0.14056421,0.31000386072842245
gnb,Green Bay Packers,2,Detroit Lions,42,21,26,488,229,259,0,19,307,218,89,1,1,1,0.14056421,0.31000386072842245
gnb,Green Bay Packers,3,New Orleans Saints,37,30,24,369,271,98,0,21,397,275,122,1,1,0,0.14056421,0.31000386072842245
gnb,Green Bay Packers,4,Atlanta Falcons,30,16,22,403,315,88,0,24,327,249,78,0,1,1,0.14056421,0.31000386072842245
gnb,Green Bay Packers,6,Tampa Bay Buccaneers,10,38,13,201,107,94,2,21,324,166,158,0,0,0,0.14056421,0.31000386072842245
gnb,Green Bay Packers,7,Houston Texans,35,20,22,379,283,96,0,20,365,286,79,1,1,0,0.14056421,0.31000386072842245
gnb,Green Bay Packers,8,Minnesota Vikings,22,28,24,400,291,109,1,20,324,151,173,0,0,1,0.14056421,0.31000386072842245
gnb,Green Bay Packers,9,San Francisco 49ers,34,17,21,405,294,111,0,17,337,282,55,2,1,0,0.14056421,0.31000386072842245
gnb,Green Bay Packers,10,Jacksonville Jaguars,24,20,16,395,315,80,2,16,260,151,109,1,1,1,0.14056421,0.31000386072842245
gnb,Green Bay Packers,11,Indianapolis Colts,31,34,21,367,301,66,4,23,420,280,140,2,0,0,0.14056421,0.31000386072842245
gnb,Green Bay Packers,12,Chicago Bears,41,25,28,393,211,182,0,26,350,229,121,3,1,1,0.14056421,0.31000386072842245
gnb,Green Bay Packers,13,Philadelphia Eagles,30,16,20,437,288,149,0,17,278,161,117,1,1,1,0.14056421,0.31000386072842245
gnb,Green Bay Packers,14,Detroit Lions,31,24,26,410,290,120,0,27,293,242,51,0,1,0,0.14056421,0.31000386072842245
gnb,Green Bay Packers,15,Carolina Panthers,24,16,20,291,96,195,0,20,364,249,115,1,1,1,0.14056421,0.31000386072842245
gnb,Green Bay Packers,16,Tennessee Titans,40,14,27,448,214,234,1,15,260,104,156,2,1,1,0.14056421,0.31000386072842245
gnb,Green Bay Packers,17,Chicago Bears,35,16,17,316,237,79,1,21,356,248,108,2,1,0,0.14056421,0.31000386072842245
det,Detroit Lions,1,Chicago Bears,23,27,25,426,288,138,1,26,363,214,149,0,0,1,0.13869694400000002,0.2179111052910907
det,Detroit Lions,2,Green Bay Packers,21,42,19,307,218,89,1,26,488,229,259,0,0,0,0.13869694400000002,0.2179111052910907
det,Detroit Lions,3,Arizona Cardinals,26,23,22,322,232,90,0,28,377,268,109,3,1,0,0.13869694400000002,0.2179111052910907
det,Detroit Lions,4,New Orleans Saints,29,35,18,281,191,90,1,29,392,228,164,1,0,1,0.13869694400000002,0.2179111052910907
det,Detroit Lions,6,Jacksonville Jaguars,34,16,25,403,223,180,1,16,275,231,44,2,1,0,0.13869694400000002,0.2179111052910907
det,Detroit Lions,7,Atlanta Falcons,23,22,21,386,322,64,0,26,388,322,66,1,1,0,0.13869694400000002,0.2179111052910907
det,Detroit Lions,8,Indianapolis Colts,21,41,20,326,297,29,2,26,366,247,119,0,0,1,0.13869694400000002,0.2179111052910907
det,Detroit Lions,9,Minnesota Vikings,20,34,30,421,292,129,3,22,487,212,275,0,0,0,0.13869694400000002,0.2179111052910907
det,Detroit Lions,10,Washington Football Team,30,27,21,372,267,105,0,34,464,375,89,1,1,1,0.13869694400000002,0.2179111052910907
det,Detroit Lions,11,Carolina Panthers,0,20,10,185,145,40,1,20,374,258,116,2,0,0,0.13869694400000002,0.2179111052910907
det,Detroit Lions,12,Houston Texans,25,41,28,388,279,109,3,21,384,307,77,1,0,1,0.13869694400000002,0.2179111052910907
det,Detroit Lions,13,Chicago Bears,34,30,24,460,400,60,1,26,389,249,140,1,1,0,0.13869694400000002,0.2179111052910907
det,Detroit Lions,14,Green Bay Packers,24,31,27,293,242,51,0,26,410,290,120,0,0,1,0.13869694400000002,0.2179111052910907
det,Detroit Lions,15,Tennessee Titans,25,46,27,430,307,123,3,28,463,268,195,0,0,0,0.13869694400000002,0.2179111052910907
det,Detroit Lions,16,Tampa Bay Buccaneers,7,47,12,186,113,73,2,30,588,477,111,0,0,1,0.13869694400000002,0.2179111052910907
det,Detroit Lions,17,Minnesota Vikings,35,37,21,417,288,129,2,31,508,383,125,0,0,1,0.13869694400000002,0.2179111052910907
atl,Atlanta Falcons,1,Seattle Seahawks,25,38,28,506,434,72,2,22,383,299,84,0,0,1,0.139822369,0.26174733034283143
atl,Atlanta Falcons,2,Dallas Cowboys,39,40,22,380,267,113,0,33,570,445,125,3,0,0,0.139822369,0.26174733034283143
atl,Atlanta Falcons,3,Chicago Bears,26,30,22,371,227,144,1,24,437,307,130,2,0,1,0.139822369,0.26174733034283143
atl,Atlanta Falcons,4,Green Bay Packers,16,30,24,327,249,78,0,22,403,315,88,0,0,0,0.139822369,0.26174733034283143
atl,Atlanta Falcons,5,Carolina Panthers,16,23,21,373,207,166,1,24,437,313,124,0,0,1,0.139822369,0.26174733034283143
atl,Atlanta Falcons,6,Minnesota Vikings,40,23,24,462,363,99,1,19,365,333,32,3,1,0,0.139822369,0.26174733034283143
atl,Atlanta Falcons,7,Detroit Lions,22,23,26,388,322,66,1,21,386,322,64,0,0,1,0.139822369,0.26174733034283143
atl,Atlanta Falcons,8,Carolina Panthers,25,17,28,401,270,131,1,18,304,157,147,1,1,0,0.139822369,0.26174733034283143
atl,Atlanta Falcons,9,Denver Broncos,34,27,23,363,271,92,1,23,405,302,103,1,1,1,0.139822369,0.26174733034283143
atl,Atlanta Falcons,11,New Orleans Saints,9,24,14,248,196,52,2,24,376,210,166,1,0,0,0.139822369,0.26174733034283143
atl,Atlanta Falcons,12,Las Vegas Raiders,43,6,23,304,179,125,1,13,243,203,40,5,1,1,0.139822369,0.26174733034283143
atl,Atlanta Falcons,13,New Orleans Saints,16,21,21,332,262,70,1,23,424,217,207,1,0,1,0.139822369,0.26174733034283143
atl,Atlanta Falcons,14,Los Angeles Chargers,17,20,19,319,249,70,3,23,345,240,105,1,0,0,0.139822369,0.26174733034283143
atl,Atlanta Falcons,15,Tampa Bay Buccaneers,27,31,23,369,332,37,0,27,416,365,51,0,0,1,0.139822369,0.26174733034283143
atl,Atlanta Falcons,16,Kansas City Chiefs,14,17,23,367,277,90,1,23,395,278,117,2,0,0,0.139822369,0.26174733034283143
atl,Atlanta Falcons,17,Tampa Bay Buccaneers,27,44,25,385,258,127,2,28,485,391,94,1,0,0,0.139822369,0.26174733034283143
was,Washington Football Team,1,Philadelphia Eagles,27,17,18,239,159,80,0,19,265,208,57,3,1,1,0.140029337,0.2670139437616801
was,Washington Football Team,2,Arizona Cardinals,15,30,19,316,199,117,2,22,438,278,160,1,0,0,0.140029337,0.2670139437616801
was,Washington Football Team,3,Cleveland Browns,20,34,19,309,206,103,5,19,300,142,158,0,0,0,0.140029337,0.2670139437616801
was,Washington Football Team,4,Baltimore Ravens,17,31,24,343,274,69,1,18,350,206,144,2,0,1,0.140029337,0.2670139437616801
was,Washington Football Team,5,Los Angeles Rams,10,30,10,108,70,38,0,20,429,300,129,1,0,1,0.140029337,0.2670139437616801
was,Washington Football Team,6,New York Giants,19,20,24,337,251,86,2,16,240,108,132,1,0,0,0.140029337,0.2670139437616801
was,Washington Football Team,7,Dallas Cowboys,25,3,21,397,189,208,0,12,142,59,83,1,1,1,0.140029337,0.2670139437616801
was,Washington Football Team,9,New York Giants,20,23,19,402,365,37,5,22,350,184,166,0,0,1,0.140029337,0.2670139437616801
was,Washington Football Team,10,Detroit Lions,27,30,34,464,375,89,1,21,372,267,105,0,0,0,0.140029337,0.2670139437616801
was,Washington Football Team,11,Cincinnati Bengals,20,9,20,325,161,164,1,18,272,202,70,2,1,1,0.140029337,0.2670139437616801
was,Washington Football Team,12,Dallas Cowboys,41,16,22,338,156,182,1,13,247,187,60,2,1,0,0.140029337,0.2670139437616801
was,Washington Football Team,13,Pittsburgh Steelers,23,17,18,318,273,45,0,17,326,305,21,1,1,0,0.140029337,0.2670139437616801
was,Washington Football Team,14,San Francisco 49ers,23,15,12,193,95,98,1,21,344,236,108,3,1,0,0.140029337,0.2670139437616801
was,Washington Football Team,15,Seattle Seahawks,15,20,26,353,269,84,2,16,302,121,181,1,0,1,0.140029337,0.2670139437616801
was,Washington Football Team,16,Carolina Panthers,13,20,20,386,278,108,4,19,280,167,113,2,0,1,0.140029337,0.2670139437616801
was,Washington Football Team,17,Philadelphia Eagles,20,14,16,248,145,103,2,16,216,98,118,3,1,0,0.140029337,0.2670139437616801
min,Minnesota Vikings,1,Green Bay Packers,34,43,25,382,248,134,1,31,522,364,158,0,0,1,0.139774866,0.2625058339201493
min,Minnesota Vikings,2,Indianapolis Colts,11,28,12,175,95,80,3,24,354,203,151,1,0,0,0.139774866,0.2625058339201493
min,Minnesota Vikings,3,Tennessee Titans,30,31,22,464,238,226,3,23,444,310,134,1,0,1,0.139774866,0.2625058339201493
min,Minnesota Vikings,4,Houston Texans,31,23,24,410,248,162,0,20,386,290,96,1,1,0,0.139774866,0.2625058339201493
min,Minnesota Vikings,5,Seattle Seahawks,26,27,31,449,248,201,2,18,314,190,124,1,0,0,0.139774866,0.2625058339201493
min,Minnesota Vikings,6,Atlanta Falcons,23,40,19,365,333,32,3,24,462,363,99,1,0,1,0.139774866,0.2625058339201493
min,Minnesota Vikings,8,Green Bay Packers,28,22,20,324,151,173,0,24,400,291,109,1,1,0,0.139774866,0.2625058339201493
min,Minnesota Vikings,9,Detroit Lions,34,20,22,487,212,275,0,30,421,292,129,3,1,1,0.139774866,0.2625058339201493
min,Minnesota Vikings,10,Chicago Bears,19,13,19,385,286,99,2,10,149,108,41,2,1,0,0.139774866,0.2625058339201493
min,Minnesota Vikings,11,Dallas Cowboys,28,31,24,430,305,125,2,24,376,196,180,1,0,1,0.139774866,0.2625058339201493
min,Minnesota Vikings,12,Carolina Panthers,28,27,26,387,291,96,3,21,374,267,107,1,1,1,0.139774866,0.2625058339201493
min,Minnesota Vikings,13,Jacksonville Jaguars,27,24,30,420,275,145,2,20,390,266,124,4,1,1,0.139774866,0.2625058339201493
min,Minnesota Vikings,14,Tampa Bay Buccaneers,14,26,27,335,173,162,1,17,303,196,107,0,0,0,0.139774866,0.2625058339201493
min,Minnesota Vikings,15,Chicago Bears,27,33,26,407,249,158,1,23,397,198,199,1,0,1,0.139774866,0.2625058339201493
min,Minnesota Vikings,16,New Orleans Saints,33,52,25,364,274,90,0,36,583,319,264,2,0,0,0.139774866,0.2625058339201493
min,Minnesota Vikings,17,Detroit Lions,37,35,31,508,383,125,0,21,417,288,129,2,1,0,0.139774866,0.2625058339201493
dal,Dallas Cowboys,1,Los Angeles Rams,17,20,24,380,244,136,0,23,422,269,153,1,0,0,0.139511791,0.2473068836300311
dal,Dallas Cowboys,2,Atlanta Falcons,40,39,33,570,445,125,3,22,380,267,113,0,1,1,0.139511791,0.2473068836300311
dal,Dallas Cowboys,3,Seattle Seahawks,31,38,27,522,461,61,3,23,412,295,117,1,0,0,0.139511791,0.2473068836300311
dal,Dallas Cowboys,4,Cleveland Browns,38,49,35,566,481,85,3,33,508,201,307,0,0,1,0.139511791,0.2473068836300311
dal,Dallas Cowboys,5,New York Giants,37,34,28,402,276,126,2,20,300,211,89,1,1,1,0.139511791,0.2473068836300311
dal,Dallas Cowboys,6,Arizona Cardinals,10,38,27,344,247,97,4,22,438,177,261,0,0,1,0.139511791,0.2473068836300311
dal,Dallas Cowboys,7,Washington Football Team,3,25,12,142,59,83,1,21,397,189,208,0,0,0,0.139511791,0.2473068836300311
dal,Dallas Cowboys,8,Philadelphia Eagles,9,23,21,265,132,133,2,18,222,103,119,4,0,0,0.139511791,0.2473068836300311
dal,Dallas Cowboys,9,Pittsburgh Steelers,19,24,19,364,220,144,2,20,355,309,46,0,0,1,0.139511791,0.2473068836300311
dal,Dallas Cowboys,11,Minnesota Vikings,31,28,24,376,196,180,1,24,430,305,125,2,1,0,0.139511791,0.2473068836300311
dal,Dallas Cowboys,12,Washington Football Team,16,41,13,247,187,60,2,22,338,156,182,1,0,1,0.139511791,0.2473068836300311
dal,Dallas Cowboys,13,Baltimore Ravens,17,34,29,388,277,111,1,19,401,107,294,1,0,0,0.139511791,0.2473068836300311
dal,Dallas Cowboys,14,Cincinnati Bengals,30,7,16,272,171,101,0,18,309,208,101,3,1,0,0.139511791,0.2473068836300311
dal,Dallas Cowboys,15,San Francisco 49ers,41,33,15,291,204,87,0,28,458,308,150,4,1,1,0.139511791,0.2473068836300311
dal,Dallas Cowboys,16,Philadelphia Eagles,37,17,22,513,362,151,1,24,477,326,151,3,1,1,0.139511791,0.2473068836300311
dal,Dallas Cowboys,17,New York Giants,19,23,26,307,199,108,1,22,336,211,125,2,0,0,0.139511791,0.2473068836300311
phi,Philadelphia Eagles,1,Washington Football Team,17,27,19,265,208,57,3,18,239,159,80,0,0,0,0.13880894,0.18042987123767812
phi,Philadelphia Eagles,2,Los Angeles Rams,19,37,25,363,242,121,3,30,449,258,191,1,0,1,0.13880894,0.18042987123767812
phi,Philadelphia Eagles,3,Cincinnati Bengals,23,23,27,381,206,175,2,24,304,256,48,0,0,1,0.13880894,0.18042987123767812
phi,Philadelphia Eagles,4,San Francisco 49ers,25,20,18,267,174,93,1,25,417,301,116,3,1,0,0.13880894,0.18042987123767812
phi,Philadelphia Eagles,5,Pittsburgh Steelers,29,38,20,336,242,94,2,25,367,231,136,1,0,0,0.13880894,0.18042987123767812
phi,Philadelphia Eagles,6,Baltimore Ravens,28,30,19,364,170,194,1,17,355,173,182,0,0,1,0.13880894,0.18042987123767812
phi,Philadelphia Eagles,7,New York Giants,22,21,27,442,346,96,1,17,325,165,160,3,1,1,0.13880894,0.18042987123767812
phi,Philadelphia Eagles,8,Dallas Cowboys,23,9,18,222,103,119,4,21,265,132,133,2,1,1,0.13880894,0.18042987123767812
phi,Philadelphia Eagles,10,New York Giants,17,27,22,346,190,156,0,22,382,231,151,0,0,0,0.13880894,0.18042987123767812
phi,Philadelphia Eagles,11,Cleveland Browns,17,22,19,315,209,106,3,17,324,187,137,1,0,0,0.13880894,0.18042987123767812
phi,Philadelphia Eagles,12,Seattle Seahawks,17,23,18,250,180,70,1,20,301,225,76,0,0,1,0.13880894,0.18042987123767812
phi,Philadelphia Eagles,13,Green Bay Packers,16,30,17,278,161,117,1,20,437,288,149,0,0,0,0.13880894,0.18042987123767812
phi,Philadelphia Eagles,14,New Orleans Saints,24,21,21,413,167,246,1,20,358,262,96,2,1,1,0.13880894,0.18042987123767812
phi,Philadelphia Eagles,15,Arizona Cardinals,26,33,26,422,305,117,0,26,526,423,103,3,0,0,0.13880894,0.18042987123767812
phi,Philadelphia Eagles,16,Dallas Cowboys,17,37,24,477,326,151,3,22,513,362,151,1,0,0,0.13880894,0.18042987123767812
phi,Philadelphia Eagles,17,Washington Football Team,14,20,16,216,98,118,3,16,248,145,103,2,0,1,0.13880894,0.18042987123767812
nyg,New York Giants,1,Pittsburgh Steelers,16,26,20,291,262,29,2,19,349,208,141,1,0,1,0.139260314,0.2441096244751387
nyg,New York Giants,2,Chicago Bears,13,17,22,295,220,75,2,18,304,169,135,2,0,0,0.139260314,0.2441096244751387
nyg,New York Giants,3,San Francisco 49ers,9,36,13,231,165,66,3,29,420,327,93,0,0,1,0.139260314,0.2441096244751387
nyg,New York Giants,4,Los Angeles Rams,9,17,19,295,159,136,1,15,240,182,58,1,0,0,0.139260314,0.2441096244751387
nyg,New York Giants,5,Dallas Cowboys,34,37,20,300,211,89,1,28,402,276,126,2,0,0,0.139260314,0.2441096244751387
nyg,New York Giants,6,Washington Football Team,20,19,16,240,108,132,1,24,337,251,86,2,1,1,0.139260314,0.2441096244751387
nyg,New York Giants,7,Philadelphia Eagles,21,22,17,325,165,160,3,27,442,346,96,1,0,0,0.139260314,0.2441096244751387
nyg,New York Giants,8,Tampa Bay Buccaneers,23,25,24,357,256,101,2,23,344,263,81,1,0,1,0.139260314,0.2441096244751387
nyg,New York Giants,9,Washington Football Team,23,20,22,350,184,166,0,19,402,365,37,5,1,0,0.139260314,0.2441096244751387
nyg,New York Giants,10,Philadelphia Eagles,27,17,22,382,231,151,0,22,346,190,156,0,1,1,0.139260314,0.2441096244751387
nyg,New York Giants,12,Cincinnati Bengals,19,17,19,386,244,142,1,11,155,115,40,3,1,0,0.139260314,0.2441096244751387
nyg,New York Giants,13,Seattle Seahawks,17,12,13,290,100,190,1,21,327,216,111,2,1,0,0.139260314,0.2441096244751387
nyg,New York Giants,14,Arizona Cardinals,7,26,10,159,81,78,3,22,390,231,159,0,0,1,0.139260314,0.2441096244751387
nyg,New York Giants,15,Cleveland Browns,6,20,14,288,214,74,0,24,392,286,106,0,0,1,0.139260314,0.2441096244751387
nyg,New York Giants,16,Baltimore Ravens,13,27,24,269,215,54,0,25,432,183,249,1,0,0,0.139260314,0.2441096244751387
nyg,New York Giants,17,Dallas Cowboys,23,19,22,336,211,125,2,26,307,199,108,1,1,1,0.139260314,0.2441096244751387
